#,#,#,#,#
E,.,.,.,S
#,P,.,P,#
#,P,.,P,#
#,#,#,#,#