#,#,#,#,#
#,.,.,.,S
#,.,#,.,#
#,C,.,.,E
#,#,#,#,#