#,#,#,#,#,#,#,#,#,#,#,#,#,#,#,#,#,#,#,#
#,C,.,.,.,.,.,.,.,.,.,.,.,.,.,.,.,.,,#
#,.,P,P,P,P,P,P,.,.,.,.,P,P,P,P,P,P,.,#
#,.,P,P,P,P,P,P,.,.,.,.,P,P,P,P,P,P,.,#
#,.,.,.,.,.,.,.,.,.,.,.,.,.,.,.,.,.,.,#
#,.,P,P,P,P,P,P,.,.,.,.,P,P,P,P,P,P,.,#
#,.,P,P,P,P,P,P,.,.,.,.,P,P,P,P,P,P,.,#
#,.,.,.,.,.,.,.,.,.,.,.,.,.,.,.,.,.,.,#
#,.,P,P,P,P,P,P,.,.,.,.,D,D,P,P,P,P,.,#
#,.,P,P,P,P,P,P,.,.,.,.,D,D,P,P,P,P,.,#
#,.,.,.,.,.,.,.,.,O,S,.,.,.,.,.,.,.,.,#
#,.,P,P,P,P,P,P,.,.,.,.,L,L,P,P,P,P,.,#
#,.,P,P,P,P,P,P,.,.,.,.,L,L,P,P,P,P,.,#
#,.,.,.,.,.,.,.,.,.,.,.,.,.,.,.,.,.,.,#
#,.,P,P,P,P,P,P,.,.,.,.,P,P,P,P,P,P,.,#
#,.,P,P,P,P,P,P,.,.,.,.,P,P,P,P,P,P,.,#
#,.,.,.,.,.,.,.,.,.,.,.,.,.,.,.,.,.,.,#
#,.,P,P,P,P,P,P,.,.,.,.,P,P,P,P,P,P,.,#
#,#,#,#,#,#,#,#,#,#,#,#,#,#,#,#,#,#,#,#
