#,#,#,#,#,#,#,#,#,#,#,#,#,#,#,#,#,#,#
C,>,.,.,.,.,.,.,.,.,.,.,.,.,.,.,.,V,#
#,.,P,P,P,#,P,P,P,#,P,P,P,#,P,P,P,.,#
O,^,P,P,P,#,P,P,P,#,P,P,P,#,P,P,P,.,#
O,.,<,.,.,.,.,.,.,.,.,.,.,.,.,.,.,.,#
#,^,P,P,P,#,P,P,P,#,P,P,P,#,P,P,P,.,#
#,.,P,P,P,#,P,P,P,#,P,P,P,#,P,P,P,V,#
