#,#,#,#,#,#,#,#,#,#,#,#,#,#,#,#,#,#,#,#
#,C,>,.,.,.,.,.,.,.,.,.,.,.,.,.,.,.,.,#
#,.,P,P,P,P,P,P,V,V,^,^,P,P,P,P,P,P,V,#
#,^,P,P,P,P,P,P,.,.,.,.,P,P,P,P,P,P,.,#
#,.,.,.,.,.,.,.,.,.,.,.,.,.,.,.,.,.,.,#
#,.,P,P,P,P,P,P,V,V,^,^,P,P,P,P,P,P,.,#
#,.,P,P,P,P,P,P,V,V,^,^,P,P,P,P,P,P,.,#
#,.,<,.,.,.,.,.,.,.,.,.,.,.,.,.,.,<,.,#
#,.,P,P,P,P,P,P,V,V,^,^,D,D,P,P,P,P,.,#
#,.,P,P,P,P,P,P,V,V,^,^,D,D,P,P,P,P,.,#
#,.,.,.,.,.,.,.,.,.,S,.,.,.,.,.,.,.,.,#
#,.,P,P,P,P,P,P,V,V,^,^,L,L,P,P,P,P,.,#
#,.,P,P,P,P,P,P,V,V,^,^,L,L,P,P,P,P,.,#
#,.,.,.,.,.,.,.,.,.,.,.,.,.,.,.,.,.,.,#
#,.,P,P,P,P,P,P,V,V,^,^,P,P,P,P,P,P,.,#
#,.,P,P,P,P,P,P,V,V,^,^,P,P,P,P,P,P,.,#
#,.,.,.,.,.,.,.,.,.,.,.,.,.,.,.,.,.,.,#
#,.,P,P,P,P,P,P,#,O,#,#,P,P,P,P,P,P,.,#
#,#,#,#,#,#,#,#,#,#,#,#,#,#,#,#,#,#,#,#
