#,#,#,#,#,#,#,#,#,#,#,#,#,#,#,#,#,#,#,#
#,.,.,.,.,.,.,.,.,.,.,.,.,.,.,.,.,.,.,#
#,.,#,#,#,#,#,#,.,.,.,.,#,#,#,#,#,#,.,#
#,.,#,#,#,#,#,#,.,.,.,.,#,#,#,#,#,#,.,#
#,.,.,.,.,.,.,.,.,.,.,.,.,.,.,.,.,.,.,#
#,.,#,#,#,#,#,#,.,.,.,.,#,#,#,#,#,#,.,#
#,.,#,#,#,#,#,#,.,.,.,.,#,#,#,#,#,#,.,#
#,.,.,.,.,.,.,.,.,.,.,.,.,.,.,.,.,.,.,#
#,.,#,#,#,#,#,#,.,.,.,.,#,#,#,#,#,#,.,#
#,.,#,#,#,#,#,#,.,.,.,.,#,#,#,#,#,#,.,#
#,.,.,.,.,.,.,.,.,.,S,.,.,.,.,.,.,.,.,#
#,.,#,#,#,#,#,#,.,.,.,.,#,#,#,#,#,#,.,#
#,.,#,#,#,#,#,#,.,.,.,.,#,#,#,#,#,#,.,#
#,.,.,.,.,.,.,.,.,.,.,.,.,.,.,.,.,.,.,#
#,.,#,#,#,#,#,#,.,.,.,.,#,#,#,#,#,#,.,#
#,.,#,#,#,#,#,#,.,.,.,.,#,#,#,#,#,#,.,#
#,.,.,.,.,.,.,.,.,.,.,.,.,.,.,.,.,.,.,#
#,.,#,#,#,#,#,#,.,.,.,.,#,#,#,#,#,#,.,#
#,#,#,#,#,#,#,#,#,O,#,#,#,#,#,#,#,#,#,#
