#,#,#,#,#
E,.,.,.,S
#,.,#,.,#
P,.,#,.,P
#,#,#,#,#